11111111111111111111111111111111
100000000000000000P0000000000001
10000000000111000000000000000001
10110000100100000000001111110001
10010000000100000000001000010001
111100001C0100000000001000010001
11110000100110C00000001000010001
10010000000001100000001111110001
11111010100100000000000000000001
10000011000100E00000000000000001
11111111111111100011111111111111
11111111111111100011111111111111
10000000000000000000000000000001
10000000000000000000000000011101
10000000110111000011000010010001
10000000100001000001000000010001
1000000010000100011100001C010001
100000001000010001110000100110C1
10000000111111000001000000000111
10000000000000000111101010010001
10000000000000000000001100010001
11111111111111111111111111111111